...!!!!..E
...!!!!...
...!!!!...
..........
..........
..........
..........
...!!!!...
...!!!!...
S..!!!!...