S#.#.#.#.#
.#.#.#.#.#
.#.#.#.#.#
.#.#.#.#.#
.#.#.#.#.#
.#.#.#.#.#
.#.#.#.#.#
.#.#.#.#.#
.#.#.#.#.#
.........E