E.........
..........
..........
...###....
...#S#....
...#.#....
...#.#....
..........
..........
..........