..........
..######..
.......#.E
.......#..
.......#..
.......#..
.......#..
.......#..
S.######..
..........